16 25
1 1 1 1 1 1 1 1 1 1 1 1 1 1 1 1
1 0 0 0 0 0 0 0 0 0 0 0 P 0 0 1
1 0 0 0 0 0 0 0 0 0 0 0 0 0 0 1
1 0 0 0 0 0 0 1 1 $ $ 1 1 1 1 1
1 0 0 0 0 0 0 1 1 0 0 1 0 $ 0 1
1 0 0 0 0 0 0 1 1 0 0 1 0 0 0 1
1 0 0 0 1 1 1 1 1 0 0 1 0 0 0 1
1 0 0 0 1 1 1 1 1 0 0 0 0 0 0 1
1 0 0 0 0 0 0 0 0 0 0 0 0 0 0 1
1 0 0 0 0 0 0 0 0 0 0 1 0 0 0 1
1 0 0 0 0 0 0 0 0 0 0 1 1 0 0 1
1 0 0 1 1 1 1 0 0 0 0 0 1 1 0 1
1 0 0 $ $ 0 0 0 0 0 0 0 0 0 0 1
1 1 1 1 1 0 S 0 0 0 0 0 0 0 0 1
1 0 0 0 1 0 0 0 0 0 0 1 1 1 1 1
1 0 1 0 1 0 0 0 0 0 0 0 0 0 0 1
1 0 1 0 1 0 0 0 0 0 0 0 0 0 0 1
1 0 1 0 1 0 0 0 1 1 1 0 0 0 0 1
1 1 1 1 1 0 0 0 1 1 1 0 0 0 0 1
1 0 0 0 1 0 0 0 1 1 1 0 0 0 0 1
1 1 1 1 1 0 0 0 0 0 0 0 0 0 0 1
1 H 0 $ 1 0 0 0 0 B 0 0 0 0 0 1
1 T T 0 0 0 0 1 1 1 1 0 0 0 0 1
1 T T 0 0 0 0 0 0 0 0 0 0 0 0 1
1 1 1 1 1 1 1 1 1 1 1 1 1 1 1 1